dispo	por_cada
aerosol	no
ampolla	si
bolsa	no
cápsula	si
cartucho	si
comprimido	si
crema	no
disparo	si
elixir	no
emulsión	no
espuma	no
frasco	si
gas	no
gel	no
gotas	no
gránulos	no
jeringa	si
loción	no
óvulo	si
parche	si
pasta	no
pastilla	si
polvo	no
sachet	si
solución	no
supositorio	si
suspensión	no
ungüento	no
vial	si
